7 30
|A||||||||||||||||||||||||||||
| |     |          | |       |
|   ||| | |||||||| | | ||||| |
| |   |   |   |  | |   |     |
| ||| ||||| | || | ||| | | |||
|   |       |    |     | |   |
||||||||||||||||||||||||B|||||